{
	"heal_health": [[17, 8], [14, 8]],
	"doors" : [
		{ "x":-16, "y":64, "width":16, "height":1600,
		"destination_zone":"00", "destination_x":640, "destination_y":-1 },
		{ "x":640, "y":64, "width":16, "height":1600,
		"destination_zone":"00", "destination_x":0, "destination_y":-1 }
	],
	"columns":20,
	"rows"   :9,
	"graphical_map":[73,74,73,74,73,74,73,74,73,73,73,74,73,73,74,74,73,74,73,74,
					73,74,73,74,73,74,73,74,73,73,73,74,73,73,74,74,73,74,73,74,
					73,74,73,74,73,74,73,74,73,73,73,74,73,73,74,74,73,74,73,74,
					73,74,73,74,73,74,73,74,73,73,73,74,73,73,74,74,73,74,73,74,
					73,74,73,74,73,74,73,74,73,73,73,74,73,73,74,74,73,74,73,74,
					73,74,73,74,73,74,73,74,73,73,73,74,73,73,74,74,73,74,73,74,
					73,74,73,74,73,74,73,74,73,73,73,74,73,73,74,74,73,74,73,74,
					73,74,73,74,73,74,73,74,73,73,73,74,73,73,74,74,73,74,73,74,
					 0, 1, 2, 2, 2, 2, 2, 2, 2, 2, 2, 2, 2, 2, 2, 2, 2, 2, 2, 3
	],
	"collision_map":[ 0, 4, 4, 4, 0, 0, 4, 4, 4, 4, 4, 4, 4, 0, 4, 4, 4, 4, 4, 0,
					 0, 0, 0, 0, 0, 0, 0, 0, 0, 0, 0, 0, 0, 0, 0, 0, 0, 0, 0, 0,
					 0, 0, 0, 0, 0, 0, 0, 0, 0, 0, 0, 0, 0, 0, 0, 0, 0, 0, 0, 0,
					 0, 0, 0, 0, 0, 0, 0, 0, 0, 0, 0, 0, 0, 0, 0, 0, 0, 0, 0, 0,
					 0, 0, 0, 0, 0, 0, 0, 0, 0, 0, 0, 0, 0, 0, 0, 0, 0, 0, 0, 0,
					 0, 0, 0, 0, 0, 0, 0, 0, 0, 0, 0, 0, 0, 0, 0, 0, 0, 0, 0, 0,
					 0, 0, 0, 0, 0, 0, 0, 0, 0, 0, 0, 0, 0, 0, 0, 0, 0, 0, 0, 0,
					 0, 0, 0, 0, 0, 0, 0, 0, 0, 0, 0, 0, 0, 0, 0, 0, 0, 0, 0, 0,
					 0, 1, 1, 1, 1, 1, 1, 1, 1, 1, 1, 1, 1, 1, 1, 1, 1, 1, 1, 1
	],
	"id":"00"
}
