{
	"heal_health": [[17, 4.5], [14, 6.5]],
	"torch": [],
	"doors" : [
		{ "x":640, "y":64, "width":16, "height":1600,
		"destination_zone":"01", "destination_x":0, "destination_y":-1 }
	],
	"columns":20,
	"rows"   :9,
	"graphical_map":[
		 75, 76, 90, 91, 92, 77, 90, 91, 92, 76, 90, 91, 92, 77, 76, 77, 76, 76, 77, 77,
		 79, 66, 93, 94, 95, 74, 93, 94, 95, 73, 93, 94, 95, 73, 74, 74, 73, 74, 65, 74,
		 79, 74, 93, 91, 95, 74, 93, 91, 95, 73, 93, 91, 95, 73, 65, 74, 73, 74, 73, 74,
		 79,136, 93, 94, 95,136, 93, 94, 95,136, 93, 94, 95, 73, 74, 66, 73, 74, 73, 74,
		 79,139, 93, 91, 95,139, 93, 91, 95,139, 93, 91, 95, 73, 74, 74, 73, 74, 73, 74,
		 79,137, 93, 94, 95,137, 93, 94, 95,137, 93, 94, 95, 73, 74,108,109,110,110,111,
		 79, 74, 96, 97, 98, 74, 96, 97, 98, 73, 96, 97, 98, 73, 74, 74, 73, 74, 73, 74,
		 79, 74, 99,100,101, 74, 99,100,101, 73, 99,100,101,  0,  1,  2,  2,  2,  2,  3,
		  0,  1,  2,  2,  2,  2,  2,  2,  2,  2,  2,  2,  2,  2,  2,  2,  2,  2,  2,  2
	],
	"collision_map":[ 
		0, 4, 4, 4, 0, 0, 4, 4, 4, 4, 4, 4, 4, 0, 4, 4, 4, 4, 4, 0,
		0, 0, 0, 0, 0, 0, 0, 0, 0, 0, 0, 0, 0, 0, 0, 0, 0, 0, 0, 0,
		0, 0, 0, 0, 0, 0, 0, 0, 0, 0, 0, 0, 0, 0, 0, 0, 0, 0, 0, 0,
		0, 0, 0, 0, 0, 0, 0, 0, 0, 0, 0, 0, 0, 0, 0, 0, 0, 0, 0, 0,
		0, 0, 0, 0, 0, 0, 0, 0, 0, 0, 0, 0, 0, 0, 0, 0, 0, 0, 0, 0,
		0, 0, 0, 0, 0, 0, 0, 0, 0, 0, 0, 0, 0, 0, 0, 0, 1, 1, 1, 0,
		0, 0, 0, 0, 0, 0, 0, 0, 0, 0, 0, 0, 0, 0, 0, 0, 0, 0, 0, 0,
		0, 0, 0, 0, 0, 0, 0, 0, 0, 0, 0, 0, 0, 0, 1, 1, 1, 1, 1, 1,
		1, 1, 1, 1, 1, 1, 1, 1, 1, 1, 1, 1, 1, 1, 1, 1, 1, 1, 1, 1
	],
	"id":"00"
}


