{
	"doors" : [
		{ "x":-16, "y":64, "width":16, "height":1600,
		"destination_zone":"00", "destination_x":640, "destination_y":-1 },
		{ "x":640, "y":64, "width":16, "height":1600,
		"destination_zone":"00", "destination_x":0, "destination_y":-1 }
	],
	"columns":20,
	"rows"   :11,
	"graphical_map":[
		162,163,164,165,164,179,197,179,197,179,197,179,197,179,179,197,197,179,197,179,
		180,181,179,197,197,179,197,179,197,179,197,179,197,179,179,197,197,179,197,179,
		162,163,197,179,197,179,197,179,197,179,197,179,197,179,179,197,197,179,197,179,
		180,181,197,179,197,179,197,179,197,179,197,179,197,179,179,197,197,179,197,179,
		162,163,182,179,197,179,197,179,197,179,197,179,173,174,174,191,197,179,197,
		179,197,179,197,179,197,177,197,179,197,130,197,179,197,44,45,179,197,179,197,
		179,197,179,197,179,177,177,197,179,197,179,197,179,197,46,47,179,197,179,197,
		179,197,179,197,177,193,186,194,194,194,186,186,197,179,48,49,197,197,179,197,
		194,194,194,194,193, 186, 186, 186, 186, 186, 0, 2, 2, 2,194,194,194,194,194,194
	],
	"collision_map":[ 
		0, 4, 4, 4, 0, 0, 4, 4, 4, 4, 4, 4, 4, 0, 4, 4, 4, 4, 4, 0,
		0, 0, 0, 0, 0, 0, 0, 0, 0, 0, 0, 0, 0, 0, 0, 0, 0, 0, 0, 0,
		0, 0, 0, 0, 0, 0, 0, 0, 0, 0, 0, 0, 0, 0, 0, 0, 0, 0, 0, 0,
		0, 0, 0, 0, 0, 0, 0, 0, 0, 0, 0, 0, 0, 0, 0, 0, 0, 0, 0, 0,
		0, 0, 0, 0, 0, 0, 0, 0, 0, 0, 0, 0, 0, 0, 0, 0, 0, 0, 0, 0,
		0, 0, 0, 0, 0, 0, 0, 0, 0, 0, 0, 0, 0, 0, 0, 0, 0, 0, 0, 0,
		0, 0, 2, 0, 1, 0, 6, 0, 0, 0, 0, 0, 0, 0, 0, 0, 0, 0, 0, 0,
		0, 0, 0, 0, 0, 0, 0, 0, 0, 0, 0, 0, 0, 0, 0, 0, 0, 0, 0, 0,
		0, 1, 1, 1, 1, 1, 1, 1, 1, 1, 1, 1, 1, 1, 1, 1, 1, 1, 1, 1
	],
	"id":"00"
}
