{
	"heal_health": [],
	"monster_normale": [[17, 4.5]],
	"monster_fly": [],
	"monster_jumper": [[14, 3.5]],
	"monster_contactjump": [],
	"torch": [[3.3, 1], [7.3, 1], [11.3, 1], [15.3, 1]],
	"doors" : [
		{ "x":-16, "y":64, "width":16, "height":1600,
		"destination_zone":"01", "destination_x":640, "destination_y":-1 },
		{ "x":640, "y":64, "width":16, "height":1600,
		"destination_zone":"03", "destination_x":0, "destination_y":-1 }
	],
	"columns":20,
	"rows"   :9,
	"graphical_map":[
		 77, 44, 45, 76, 77, 44, 45, 76, 76, 44, 45, 77, 76, 44, 45, 77, 76, 44, 45, 77,
		 73, 46, 47, 74, 73, 46, 47, 74, 73, 46, 47, 74, 73, 46, 47, 74, 73, 46, 47, 74,
		 66, 46, 47, 74, 73, 46, 47, 74, 73, 46, 47, 74, 73, 46, 47, 74, 73, 46, 47, 74,
		 73, 46, 47, 74, 73, 46, 47, 74, 73, 46, 47, 65, 73, 46, 47, 74, 73, 46, 47, 74,
		 73, 46, 47, 74, 73, 46, 47, 74, 73, 46, 47, 74, 73, 46, 47, 74, 73, 46, 47, 74,
		 73, 46, 47, 74, 73, 46, 47, 74, 73, 46, 47, 74, 66, 46, 47, 74, 73, 46, 47, 74,
		 73, 48, 49, 74, 73, 48, 49, 74, 73, 48, 49, 74, 73, 48, 49, 74, 73, 48, 49, 74,
		 73, 50, 51, 74, 73, 50, 51, 74, 73, 50, 51, 74, 73, 50, 51, 74, 73, 50, 51, 74,
		  1,  1,  2,  2,  2,  2,  2,  2,  2,  2,  2,  2,  2,  2,  2,  2,  2,  2,  2,  3
   ],
	"collision_map":[ 
		 0, 4, 4, 4, 0, 0, 4, 4, 4, 4, 4, 4, 4, 0, 4, 4, 4, 4, 4, 0,
		 0, 0, 0, 0, 0, 0, 0, 0, 0, 0, 0, 0, 0, 0, 0, 0, 0, 0, 0, 0,
		 0, 0, 0, 0, 0, 0, 0, 0, 0, 0, 0, 0, 0, 0, 0, 0, 0, 0, 0, 0,
		 0, 0, 0, 0, 0, 0, 0, 0, 0, 0, 0, 0, 0, 0, 0, 0, 0, 0, 0, 0,
		 0, 0, 0, 0, 0, 0, 0, 0, 0, 0, 0, 0, 0, 0, 0, 0, 0, 0, 0, 0,
		 0, 0, 0, 0, 0, 0, 0, 0, 0, 0, 0, 0, 0, 0, 0, 0, 0, 0, 0, 0,
		 0, 0, 0, 0, 0, 0, 0, 0, 0, 0, 0, 0, 0, 0, 0, 0, 0, 0, 0, 0,
		 0, 0, 0, 0, 0, 0, 0, 0, 0, 0, 0, 0, 0, 0, 0, 0, 0, 0, 0, 0,
		 1, 1, 1, 1, 1, 1, 1, 1, 1, 1, 1, 1, 1, 1, 1, 1, 1, 1, 1, 1
	],
	"id":"00"
}
