{
	"heal_health": [[7, 8], [14, 8]],
	"doors" : [
		{ "x":640, "y":64, "width":16, "height":1600,
		"destination_zone":"01", "destination_x":0, "destination_y":-1 }
	],
	"columns":20,
	"rows"   :11,
	"graphical_map":[
		72,72,72,72,72,72,72,72,89,73,73,74,73,73,74,74,73,74,73,74,
		72,72,72,72,72,72,72,72,89,73,73,74,73,73,74,74,73,74,73,74,
		39,39,39,39,39,39,39,39,43,73,73,74,73,73,74,74,73,74,73,74,
		77,75,44,45,76,76,76,76,76,75,75,74,73,73,74,74,73,74,73,74,
		73,74,14,15,73,74,73,136,151,73,73,74,73,73,74,74,73,74,73,74,
		73,74,14,15,73,74,73,139,152,73,73,74,73,73,74,74,122,122,73,74,
		73,74,46,47,73,74,73,140,152,73,73,74,73,73,74,122,123,74,73,74,
		73,74,48,49,73,74,73,74,73,73,73,74,73,73,122,123,73,74,73,74,
		18,19,19,19,19,19,19,19,19,19,19,19,19,32,123,19,19,19,19,3
	],
	"collision_map":[ 
		0, 4, 4, 4, 0, 0, 4, 4, 4, 4, 4, 4, 4, 0, 4, 4, 4, 4, 4, 0,
		0, 0, 0, 0, 0, 0, 0, 0, 0, 0, 0, 0, 0, 0, 0, 0, 0, 0, 0, 0,
		0, 0, 0, 0, 0, 0, 0, 0, 0, 0, 0, 0, 0, 0, 0, 0, 0, 0, 0, 0,
		0, 0, 0, 0, 0, 0, 0, 0, 0, 0, 0, 0, 0, 0, 0, 0, 0, 0, 0, 0,
		0, 0, 0, 0, 0, 0, 0, 0, 0, 0, 0, 0, 0, 0, 0, 0, 0, 0, 0, 0,
		0, 0, 0, 0, 0, 0, 0, 0, 0, 0, 0, 0, 0, 0, 0, 0, 0, 0, 0, 0,
		0, 0, 0, 0, 0, 0, 0, 0, 0, 0, 0, 0, 0, 0, 0, 0, 0, 0, 0, 0,
		0, 0, 0, 0, 0, 0, 0, 0, 0, 0, 0, 0, 0, 0, 0, 0, 0, 0, 0, 0,
		0, 1, 1, 1, 1, 1, 1, 1, 1, 1, 1, 1, 1, 1, 1, 1, 1, 1, 1, 1
	],
	"id":"00"
}


